+-------------------------------+---------------------------+
|                               |                           |
|                               |                           |
|                               |                           |
|                               |                           |
+-----------------------------------------------------------+
|                               |                           |
|                               |                           |
|                               |                           |
|                               |                           |
|                               |                           |
+-----------------------------------------------------------+
|                               |                           |
|                               |                           |
|                               |                           |
|                               |                           |
|                               |                           |
+-----------------------------------------------------------+
|                               |                           |
|                               |                           |
|                               |                           |
+-------------------------------+---------------------------+
